*******
*J    *
*    **
*   ***
*  ****
*******