        **   *                    
       *  *  *                    
      *    * *                    
     *  * *  *                    
     *   J   *                    
     * *   * *                    
     *  ***                       
     *       *                    
     *********                    
                                  
                                  
                                  
                                  
                                  
                                  
                                  
                                  