*****************************************************************************************************************************************************
*                                                                                                                                                   *
*                  * *       * * * ****************************                                                                                     *
*      J         *     *****                                                                                                                        *
*              *   *                                                                                                                                *
*            *****                                                   * *   * * *                                                                    *
*      *****      ****                                            ***************                                                                   *
******                                                           *****************                                                                  *
*     *                                                         *******************                                                                 *
*****************************************************************************************************************************************************
                                                                                                                                                     
                                                                                                                                                     
                                                                                                                                                     
                                                                                                                                                     
                                                                                                                                                     
                                                                                                                                                     
                                                                                                                                                     
                                                                                                                                                     