*****************************************************************************************************************************************************
*                        T                                                                                                                          *
*                  * *       * * * ****************************                                                                                     *
*                *     *****                                                                                                                  F F F *
*              *   *                                                         T                      T                                               *
*            *****                         T                         * *   * * *                                             J                      *
*      *****      ****                                            ***************                                                                   *
******                         T                                 *****************                                                      T           *
*     *                                                         *******************                                *     *          *********       *
*****************************************************************************************************************************************************
                                                                                                                                                     
                                                                                                                                                     
                                                                                                                                                     
                                                                                                                                                     
                                                                                                                                                     
                                                                                                                                                     
                                                                                                                                                     
                                                                                                                                                     