****************************************************************************************************************************************************************************************
* J                                                                                                                                                                                    *
*                                                                                                                                                                                      *
*                                                                                                                                                                                      *
*                                                                                                                                                                                      *
*                                                                                                                                                                                      *
*                                                                                                                                                                                      *
*                                                                                                                                                                                      *
*                                                                                                                                                                                      *
*                                                                                                                                                                                      *
*                                                                                                                                                                                      *
*                                                                                                                                                                                      *
*                                                                                                                                                                                      *
*                                                                                                                                                                                      *
*         *****                                                                                                                                                                        *
*   *****       *****                                                                                                                                                                  *
*                                                                                                                                                                                      *
*                 ********************* ********   *                                                                                                                                   *
*                                                *                                                                                                                                     *
*                                                  ***   *                                                                                                                             *
*                                                      *                        *                                                                                                      *
*                                                        *                     ***                                                                                                     *
*                                                          *                 *  *  *                                                                                                   *
*                                  *************************************************************************************************************                                       *
*                              ***    *                                                                                                        **                                      *
*                             *    ****                                                                                                        * *                                     *
*                              ***    *                                                                                                        *  *                                    *
*                             *    ****                                                                                                        *   *                                   *
*                              ***    *                                                                                                        *    *                                  *
*                             *    ****                                                                                                        *     *                                 *
*                              ***    *                                                                                                        *      *                                *
*                                  ****                                                                                                        *       *                               *
***************************************                                                                                                        *****************************************