****************************************************************************************************************************************************************************************
*                                                                                                                                                                                      *
*                                                                                                                                                                                      *
*                                                                                                                                                                                      *
*                                                                                                                                                                                      *
*                                                                                                                                                                                      *
*                                                                                                                                                                                      *
*                                                                                                                                                                                      *
*                                                                                                                                                                                      *
*                                                                                                                                                                                      *
*                                                                                                                                                                                      *
*                                                                                                                                                                                      *
*     J                                                                                                                                                                                *
*                                                                                                                                                                                      *
*         *****                                                                                                                                                                        *
*   *****       *****                                                                                                                                                                  *
*                                                                                                                                                                                      *
*                 ********************* ********   *                                                                                                                                   *
*                                                *                                                                                                                                     *
*                                                  ***  *                                                                                                                              *
*                                                      *                        *                                                                                                      *
*                                                        *                     ***                                                                                                     *
*                                                          *                 *  *  *                                                                                                   *
*                                     **********************************************************************************************************                                       *
*                                     *                                                                                                        *                                       *
*                                     *                                                                                                        *                                       *
*                                     *                                                                                                        *                                       *
*                                     *                                                                                                        *                                       *
*                                     *                                                                                                        *                                       *
*                                     *                                                                                                        *                                       *
*                                     *                                                                                                        *                                       *
*                                     *                                                                                                        *                                       *
***************************************                                                                                                        *****************************************