***********************************************************************************
*                                                                    J            *
*                                                                                 *
*      F F F F F F F F F F F F F F    F F F F F                                   *
*     F F F F F F F F F F F F F F      F F F F F                                  *
*                                                                                 *
*                                                                                 *
*                                                                                 *
*                                                                                 *
*                                                                                 *
*                                                                                 *
*                                                                                 *
************                                            ***************************
*           *                                          *                          *
*            *                                        *                           *
*             *                                      *                            *
*              *                                    *                             *
*               *                                  *                              *
***********************************************************************************
***********************************************************************************