*****************************************************************************************************************************************************
*                                                                                                                                                   *
*                                                                                                                                                   *
*                      * * *                                                                                                                        *
*                                                                                                                                                   *
*           * * *                                                    * *   * * *                                                                    *
*                                                                  *     *      *                                                                   *
*                                                                *              *                                                                   *
*                                                              *                  *                                                                 *
*****************************************************************************************************************************************************